NO textures/RED-BRICK.xpm
SO textures/MOSS-ROCK.xpm
WE textures/SILVER-ROCK.xpm
EA textures/BLUE-ROCK.xpm
C 64,64,64
F 128,128,128

111111111111111111111111111111111111111111111111111111111111111111111111111111111111111111111111111111111111111111111
100000000000000000000000000000000000000000000000000000000000000000000000000000000000000000000000000000000000000000001
100000000000000000000000000000000000000000000000000000000000000000000000000000000000000000000000000000000000000000001
100000000000000000000000000000000000000000000000000000000000000000000000000000000000000000000000000000000000000000001
100000000000000000000000000000000000000000000000000000000000000000000000000000000000000000000000000000000000000000001
100000000000000000000000000000000000000000000000000000000000000000000000000000000000000000000000000000000000000000001
100000000000000000000000000000000000000000000000000000000000000000000000000000000000000000000000000000000000000000001
100000000000000000000000000000000000000000000000000000000000000000000000000000000000000000000000000000000000000000001
100000000000000000000000000000000000000000000000000000000000000000000000011111111111111111111111111100000000000000001
100000000000000000000000000000000000000000000000000000000000000000000000010000000000000000000000000100000000000000001
100000000000000000000000000000000000000000000000000000000000000000000000010000000000000000000000000100000000000000001
10000000000000000000000000000000000000000000000000000000S000000000000000010000000000000000000000000100000000000000001
100000000000000000000000000000000000000000000000000000000000000000000000010000000000000000000000000100000000000000001
100000000000000000000000000000000000000000000000000000000000000000000000010000000000000000000000000100000000000000001
100000000000000000000000000000000000000000000000000000000000000000000000010000000000000000000000000100000000000000001
10000000000000000000000000000000000000000   0000000000000000000000000000011111111111111111111111111100000000000000001
10000000000000000000000000000000000000000   0000000000000000000000000000000000000000000000000000000000000000000000001
100000000000000000000000000000000000000000000000000000000000000000000000000000000000000000000000000000000000000000001
100000000000000000000000000000000000000000000000000000000000000000000000000000000000000000000000000000000000000000001
100000000000000000000000000000000000000000000000000000000000000000000000000000000000000000000000000000000000000000001
100000000000000000000000000000000000000000000000000000000000000000000000000000000000000000000000000000000000000000001
100000000000000000000000000000000000000000000000000000000000000000000000000000000000000000000000000000000000000000001
100000000000000000000000000000000000000000000000000000000000000000000000000000000000000000000000000000000000000000001
100000000000000000000000000000000000000000000000000000000000000000000000000000000000000000000000000000000000000000001
100000000000000000000000000000000000000000000000000000000000000000000000000000000000000000000000000000000000000000001
100000000000111111111111111111111111111111111100000000000000000000000000000000000000000000000000000000000000000000001
1000000000001                                100000000000000000000000000000000000000000000000000000000000000000000001
1000000000001                                100000000000000000000000000000000000000000000000000000000000000000000001
1000000000001                                100000000000000000000000000000000000000000000000000000000000000000000001
1000000000001                                100000000000000000000000000000000000000000000000000000000000000000000001
1000000000001                                100000000000000000000000000000000000000000000000000000000000000000000001
1000000000001                                100000000000000000000000000000000000000000000000000000000000000000000001
100000000000111111111111111111111111111111111100000000000000000000000000000011111111100000000000000000000000000000001
10000000000000000000000000000000000000000000000000000000000000000000000000001       100000000000000000000000000000001
10000000000000000000000000000000000000000000000000000000000000000000000000001       100000000000000000000000000000001
10000000000000000000000000000000000000000000000000000000000000000000000000001       100000000000000000000000000000001
10000000000000000000000000000000000000000000000000000000000000000000000000001       100000000000000000000000000000001
10000000000000000000000000000000000000000000000000000000000000000000000000001       100000000000000000000000000000001
10000000000000000000000000000000000000000000000000000000000000000000000000001       100000000000000000000000000000001
10000000000000000000000000000000000000000000000000000000000000000000000000001       100000000000000000000000000000001
10000000000000000000000000000000000000000000000000000000000000000000000000001       100000000000000000000000000000001
10000000000000000000000000000000000000000000000000000000000000000000000000001       100000000000000000000000000000001
10000000000000000000000000000000000000000000000000000000000000000000000000001       100000000000000000000000000000001
10000000000000000000000000000000000000000000000000000000000000000000000000001       100000000000000000000000000000001
10000000000000000000000000000000000000000000000000000000000000000000000000001       100000000000000000000000000000001
10000000000000000000000000000000000000000000000000000000000000000000000000001       100000000000000000000000000000001
10000000000000000000000000000000000000000000000000000000000000000000000000001       100000000000000000000000000000001
10000000000000000000000000000000000000000000000000000000000000000000000000001       100000000000000000000000000000001
100000000000000011111111111111111111111111111111000000000000000000000000000011111111100000000000000000000000000000001
100000000000000000000000000000000000000000000000000000000000000000000000000000000000000000000000000000000000000000001
100000000000000000000000000000000000000000000000000000000000000000000000000000000000000000000000000000000000000000001
100000000000000000000000000000000000000000000000000000000000000000000000000000000000000000000000000000000000000000001
100000000000000000000000000000000000000000000000000000000000000000000000000000000000000000000000000000000000000000001
100000000000000000000000000000000000000000000000000000000000000000000000000000000000000000000000000000000000000000001
100000000000000000000000000000000000000000000000000000000000000000000000000000000000000000000000000000000000000000001
100000000000000000000000000000000000000000000000000000000000000000000000000000000000000000000000000000000000000000001
100000000000000000000000000000000000000000000000000000000000000000000000000000000000000000000000000000000000000000001
100000000000000000000000000000000000000000000000000000000000000000000000000000000000000000000000000000000000000000001
100000000000000000000000000000000000000000000000000000000000000000000000000000000000000000000000000000000000000000001
100000000000000000000000000000000000000000000000000000000000000000000000000000000000000000000000000000000000000000001
100000000000000000000000000000000000000000000000000000000000000000000000000000000000000000000000000000000000000000001
111111111111111111111111111111111111111111111111111111111111111111111111111111111111111111111111111111111111111111111