NO textures/RED-BRICK.xpm
SO textures/MOSS-ROCK.xpm
WE textures/SILVER-ROCK.xpm
EA textures/BLUE-ROCK.xpm
C 64,64,64
F 128,128,128

111111111111111111111111111111111111111111111111111
100000000000000000000000000000000000000000000000001
100000000000000000000000000000000000000000000000001
111111111111111111111111111111111111111111111111001
100000000000000000000000000000000000000000000001001
100000000000000000000000000000000000000000000001001
100111111111111111111111111111111111111111111001001
100100000000000000000000000000000000000000001001001
100100000000000000000000000000000000000000001001001
100100111111111111111111111111111111111111001001001
100100100000000000000000000000000000000001001001001
100100100000000000000000000000000000000001001001001
100100100111111111111111111111111111111001001001001
1001001001E0000000000000000000000000000001001001001
100100100100000000000000000000000000000001001001001
100100100111111111111111111111111111111111001001001
100100100000000000000000000000000000000000001001001
100100100000000000000000000000000000000000001001001
100100111111111111111111111111111111111111111001001
100100000000000000000000000000000000000000000001001
100100000000000000000000000000000000000000000001001
100111111111111111111111111111111111111111111111001
100000000000000000000000000000000000000000000000001
100000000000000000000000000000000000000000000000001
111111111111111111111111111111111111111111111111111

