NO textures/RED-BRICK.xpm
SO textures/BROWN-ROCK.xpm

C 64,64,64



WE textures/SILVER-ROCK.xpm
EA textures/BLUE-ROCK.xpm
F 128,128,128

  1111111      1111111111
  10000011111111000000001
1110000000000000000000001111
1000000000000000000000001001
1111100011111110001111111001
1000100000000000000000001001
1000100000000000000000001001
1000100000000000000000001001
100010000000000000000001001
1000100000000000000011111011
1000000000000000000000001001
1111100000001111111110001001
1000000000000000000000000001
1000000000000000000000001001
1000000000000000000011111001
1000100000000000000000000001
1000100000000000000000000001
1000100000000111111100000001
1000100000000100000111111111
10001000000001000001
100010000S0001000001
1000100000000100000111111111
1111111110001110000000100001
1000001000000000000000100001
1000001000000000000000100001
1000001000000000000000100001
1000001000000000000000100001
1000001000000000000000100001
1000001000000000000000100001
1000001000000000000000100001
1000001000000000000000100001
1000001000000000000000100001
1000001000000000000000100001
1000001000000000000000100001
1000001000000000000000100001
1000001000000000000000100001
1000001000000000000000100001
1000001000000000000000100001
1000001000000000000000100001
1000001000000000000000100001
1000001000000000000000100001
1000001000000000000000100001
1000001000000000000000100001
1000001000000000000000100001
1110001000000000000100000001
  10001000000000001 10111111
  100000000000000001001
  11111111111111111111 