NO textures/RED-BRICK.xpm
SO textures/MOSS-ROCK.xpm
WE textures/SILVER-ROCK.xpm
EA textures/BLUE-ROCK.xpm
C 64,64,64
F 128,128,128

  1111111      1111111111
  10000011111111000000001
1110000000000000000000001111
1000000000000000000000001001
1111100011111110001111111001
1000100000000000000000001001
1000100000000000000000001001
100010000000E000000000001001
100010000000000000000001001
1000100000000000000011111011
1000000000000000000000001001
1111111111111111111111111111