NO textures/RED-BRICK.xpm
SO textures/MOSS-ROCK.xpm
WE textures/SILVER-ROCK.xpm
EA textures/BLUE-ROCK.xpm
C 64,64,64
F 128,128,128

11111
10001
10N01
10001
11111